and	nnp	b-gpe
ascii	nnp	b-gpe
additionally	rb	o
address	nn	o
alias	nnp	o
allocation	nnp	o
also	rb	o
appending	vbg	o
applying	vbg	o
arithmetic	jj	b-gpe
array	nn	o
assignability	nnp	o
assigning	vbg	o
assignments	nns	o
assume	nnp	o
backus-naur	jj	o
binary	jj	o
blank	nnp	b-person
blocks	nnp	b-person
boolean	jj	b-gpe
bootstrapping	nnp	o
break	nnp	o
built-in	jj	o
calling	vbg	o
calls	vbz	o
camelcase	nnp	b-gpe
carriage	nnp	o
cases	nns	o
category	nnp	o
channel	nnp	o
channels	nnp	o
characters	nnps	o
close	nnp	o
closing	vbg	o
comments	nns	o
communication	nn	o
comparison	nnp	o
comparisons	nns	o
complex	jj	o
composite	jj	o
computer	nnp	o
consequently	rb	o
consider	vb	o
constspec	nnp	o
constant	jj	o
constants	nns	o
continue	nnp	o
conversions	nns	o
converting	vbg	o
current	nnp	o
declarations	nns	o
defer	nnp	o
deletion	nn	o
dependency	nnp	o
ebnf	nnp	b-gpe
elements	nns	o
embeddedfield	nnp	b-gpe
empty	jj	o
errors	nnps	o
examples	nns	o
executing	vbg	o
execution	nn	o
explicit	nnp	b-person
exported	vbn	o
expression	nn	o
expressions	nns	o
extended	jj	o
fma	nnp	o
field	nnp	b-person
first	nnp	o
floating-point	jj	o
forclause	nnp	o
form	nnp	o
full	nnp	o
function	nnp	o
further	jj	o
general	jj	o
general	nnp	o
give	vb	o
given	vbn	o
go	nnp	b-gpe
go	nnp	o
goto	nnp	o
graphic	nnp	b-gpe
handling	vbg	o
here	rb	o
hexadecimal	nnp	o
however	rb	o
ieee	nnp	o
ieee-754	jj	o
identifierlist	nnp	o
identifiers	nnps	o
imaginary	nnp	o
implementation	nnp	o
import	nnp	o
importpath	nnp	b-gpe
importpaths	nnp	o
incdec	jj	o
index	nnp	b-gpe
initialization	nnp	o
instead	rb	o
integer	jjr	o
interface	nnp	o
interpreted	vbn	o
introduction	nn	o
iota	nnp	o
keywords	vb	o
label	nnp	b-person
labeled	vbn	o
labels	nnp	b-gpe
length	nnp	b-person
letter	nnp	o
letters	nns	o
lexical	jj	o
line	nnp	o
literal	jj	o
literaltype	nnp	b-gpe
ll	nnp	b-gpe
lm	nnp	b-gpe
lo	nnp	o
logical	jj	o
loosely	rb	o
lower-case	jj	o
lt	nnp	b-gpe
lu	nnp	o
making	vbg	o
manipulating	vbg	o
map	nnp	o
method	nnp	b-gpe
more	rbr	o
moreover	rb	o
multiple	nnp	o
multiplication	nn	o
nul	nnp	b-gpe
nan	nnp	o
nd	nnp	o
next	jj	o
non-exported	jj	o
non-terminals	nns	o
notation	nnp	o
note	nn	o
number	nnp	o
numeric	nnp	o
or	nnp	o
octal	jj	o
omitted	vbn	o
omitting	vbg	o
only	rb	o
operands	nns	o
operator	nnp	o
operators	nnps	o
order	nn	o
others	nns	o
otherwise	rb	o
otherwise	vb	o
overflow	nnp	b-person
package	vb	o
packagename	nnp	b-gpe
packages	nns	o
parameter	nnp	b-person
passing	vbg	o
pointer	nn	o
pointers	nns	o
predeclared	vbd	o
primary	jj	o
productions	nns	o
program	nnp	o
programs	nns	o
promoted	vbn	o
properties	nns	o
qualified	vbn	o
raw	nnp	o
receive	nnp	o
receiving	vbg	o
recvexpr	nnp	b-gpe
recvstmt	nnp	o
redeclaration	nn	o
regardless	nnp	o
represent	jj	o
representability	nnp	o
return	nnp	o
round	nnp	o
rounding	vbg	o
run-time	jj	o
rune	nnp	o
second	nnp	o
section	nn	o
see	nnp	b-person
select	jj	o
selectors	nns	o
semicolons	nnps	o
send	jj	o
sending	vbg	o
several	jj	o
shifts	nns	o
short	nnp	o
shortvardecl	nnp	o
similarly	rb	o
simple	jj	o
size	nnp	b-person
slice	nnp	o
source	nnp	b-gpe
specific	jj	o
specifically	rb	o
standard	nnp	o
statements	nns	o
string	vbg	o
strings	nns	o
struct	nn	o
structured	nnp	o
such	jj	o
suppose	vb	o
switch	nnp	b-gpe
switch	vb	o
system	nn	o
taking	vbg	o
terminating	vbg	o
there	ex	o
thus	nnp	o
together	rb	o
tokens	jj	b-gpe
type	nnp	b-person
typename	nn	o
typename	nnp	b-gpe
typespec	nnp	b-gpe
typeswitchcase	nnp	o
typeswitchguard	nnp	b-gpe
types	vbz	o
utf-8	jj	o
utf-8	nnp	b-gpe
utf-8-encoded	jj	o
utf-8-encoded	nnp	o
unary	nnp	o
unicode	nnp	b-gpe
uniqueness	nnp	o
untyped	jj	o
values	nns	o
varspec	nnp	b-gpe
variable	jj	o
variables	nns	o
white	nnp	b-person
absent	jj	o
accent	nn	o
accented	jj	o
accept	vb	o
accepts	vbz	o
access	nn	o
accessed	vbn	o
accesses	vbz	o
accessible	jj	o
accommodate	vb	o
according	vbg	o
accurately	rb	o
act	vbp	o
acts	vbz	o
actual	jj	o
add	vb	o
added	vbn	o
adding	vbg	o
addition	nn	o
additional	jj	o
additionally	rb	o
address	nn	o
addressability	nn	o
addressable	jj	o
addressed	vbn	o
addresses	nns	o
advance	vb	o
advances	nns	o
affect	vbp	o
alias	nn	o
aligned	vbn	o
alignment	nn	o
all	pdt	o
allocated	vbn	o
allocates	vbz	o
allocating	vbg	o
allow	vbp	o
allowed	vbn	o
allowing	vbg	o
allows	vbz	o
alone	rb	o
already	rb	o
also	rb	o
alternatives	nns	o
always	rb	o
ambiguity	nn	o
analysis	nn	o
analyzed	vbn	o
anew	rb	o
annotated	vbn	o
anonymous	jj	o
anywhere	rb	o
appear	vbp	o
appears	vbz	o
appends	vbz	o
applied	vbd	o
applies	nns	o
apply	rb	o
apply	vbp	o
applying	vbg	o
arbitrary	jj	o
architecture	nn	o
architecture-independent	jj	o
architectures	vbz	o
argument	nn	o
arguments	nns	o
arises	nns	o
arithmetic	jj	o
arithmetic	nn	o
array	nn	o
array	vb	o
arrays	nns	o
assemble	jj	o
assembly	nn	o
assertion	nn	o
assertions	nns	o
asserts	vbz	o
assign	vb	o
assignable	jj	o
assigned	vbn	o
assigning	vbg	o
assignment	nn	o
assignments	nns	o
assigns	vbz	o
assist	vb	o
associate	nn	o
associated	jj	o
associates	vbz	o
associativity	nn	o
assume	vb	o
assumption	nn	o
attempt	nn	o
attempting	vbg	o
attribute	nn	o
automatic	jj	o
automatically	rb	o
available	jj	o
avoid	vb	o
back	rb	o
backslash	jj	o
backslash	nn	o
backslashes	nns	o
backward	jj	o
base	nn	o
becomes	vbz	o
been	vbn	o
beginning	vbg	o
begins	nns	o
begins	vbz	o
behave	vbp	o
behavior	nn	o
belonging	vbg	o
belongs	nns	o
belongs	vbz	o
bidirectional	jj	o
binary	jj	o
bind	vbp	o
binding	nn	o
binding	vbg	o
binds	vbz	o
bit	nn	o
bits	nns	o
bitwise	nn	o
blank	jj	o
block	nn	o
blocking	vbg	o
blocks	nns	o
blocks	vbz	o
body	nn	o
boolean	jj	o
boolean	nn	o
booleans	nns	o
bootstrapping	vbg	o
bound	nn	o
bound	vbn	o
bounds	nns	o
brace	nn	o
brace-bound	jj	o
braces	nns	o
brackets	nns	o
branch	nn	o
branches	nns	o
break	nn	o
breaking	vbg	o
broken	vbn	o
buffer	nn	o
buffered	jj	o
build	jj	o
built-in	jj	o
byte	nn	o
byte-wise	nn	o
bytes	nns	o
calculated	vbn	o
call	nn	o
callable	jj	o
called	vbd	o
called	vbn	o
caller	nn	o
callers	nns	o
calling	vbg	o
calls	nns	o
calls	vbz	o
cannot	vbp	o
canonicalized	vbn	o
capacity	nn	o
carriage	nn	o
carried	vbn	o
case	nn	o
cases	nns	o
categories	nns	o
category	nn	o
cause	vb	o
causes	vbz	o
causing	vbg	o
certain	jj	o
change	vbp	o
changes	vbz	o
channel	nn	o
channels	nns	o
channels	vb	o
character	nn	o
characters	nns	o
choice	nn	o
chooses	vbz	o
chosen	vbn	o
circumstances	nns	o
class	nn	o
classes	nns	o
clause	nn	o
clauses	nns	o
closed	jj	o
closed	vbn	o
closing	vbg	o
closures	nns	o
code	nn	o
collectively	rb	o
combine	vb	o
combining	vbg	o
come	vb	o
comment	nn	o
comments	nns	o
common	jj	o
communicate	vb	o
communication	nn	o
communications	nns	o
compact	jj	o
comparable	jj	o
compare	vbp	o
compared	vbn	o
compares	vbz	o
comparing	vbg	o
comparison	nn	o
comparisons	nns	o
compatibility	nn	o
compile	jj	o
compile-time	jj	o
compiled	jj	o
compiler	nn	o
compilers	nns	o
complement	nn	o
complete	jj	o
complete	vb	o
completeness	nn	o
completes	vbz	o
complex	jj	o
component	nn	o
components	nns	o
composed	vbn	o
composes	vbz	o
composite	jj	o
comprising	vbg	o
computation	nn	o
computed	vbn	o
computes	vbz	o
computing	vbg	o
concatenated	vbn	o
concatenating	vbg	o
concatenation	nn	o
concrete	jj	o
concurrent	jj	o
concurrently	rb	o
condition	nn	o
conditional	jj	o
conditionally	rb	o
conditions	nns	o
conflict	vb	o
consequence	nn	o
consider	vb	o
considerations	nns	o
considered	vbn	o
consist	vbp	o
consisting	vbg	o
consists	vbz	o
constant	jj	o
constant	nn	o
constants	nns	o
constituents	nns	o
constrained	vbn	o
constraint	nn	o
construct	nn	o
constructed	vbn	o
construction	nn	o
constructs	vbz	o
contain	vb	o
containing	vbg	o
contains	vbz	o
contents	nns	o
context	nn	o
contexts	nns	o
contiguous	jj	o
continue	nn	o
continue	vbp	o
contrast	nn	o
control	nn	o
control	vbp	o
controlled	vbn	o
controls	vbz	o
convenience	nn	o
conventional	jj	o
conversion	nn	o
conversions	nns	o
convert	vb	o
converted	vbn	o
converting	vbg	o
copied	vbn	o
copies	vbz	o
copy	nn	o
copying	vbg	o
correct	jj	o
correspond	nn	o
corresponding	jj	o
cost	nn	o
count	nn	o
create	vb	o
created	vbn	o
creates	vbz	o
creation	nn	o
curly	rb	o
current	jj	o
cycles	nns	o
cyclic	jj	o
data	nns	o
decimal	jj	o
declaration	nn	o
declarations	nns	o
declare	vb	o
declared	vbn	o
declares	vbz	o
decrement	jj	o
default	nn	o
defaults	vbz	o
defer	nn	o
deferred	jj	o
deferred	vbn	o
defers	vbz	o
define	vb	o
defined	vbn	o
defines	vbz	o
defining	vbg	o
definition	nn	o
definitions	nns	o
delivered	vbn	o
denote	vbp	o
denoted	vbn	o
denotes	vbz	o
denoting	vbg	o
dependencies	nns	o
dependency	nn	o
depending	vbg	o
depends	vbz	o
depth	nn	o
dereference	vb	o
dereferenced	vbn	o
derive	vb	o
derived	vbn	o
described	vbn	o
describes	vbz	o
descriptor	nn	o
designed	vbn	o
destination	nn	o
detail	nn	o
determine	vb	o
determined	vbn	o
determines	vbz	o
deterministically	rb	o
development	nn	o
differ	vb	o
different	jj	o
differently	rb	o
differs	nns	o
digits	nns	o
direct	vb	o
direction	nn	o
directly	rb	o
directory	nn	o
disallow	vb	o
disallowed	vbn	o
disassemble	jj	o
discard	vb	o
discarded	vbn	o
discovered	vbn	o
discussed	vbn	o
discussion	nn	o
distinct	jj	o
divided	vbn	o
dividend	nn	o
division	nn	o
divisor	nn	o
do	vbp	o
document	nn	o
documentation	nn	o
documented	vbn	o
documents	nns	o
does	vbz	o
done	vbn	o
double	jj	o
due	jj	o
duplicate	nn	o
dynamic	jj	o
dynamically	rb	o
earlier	rbr	o
earliest	jjs	o
easy	jj	o
effect	nn	o
effects	nns	o
efficient	jj	o
element	nn	o
elementary	jj	o
elements	nns	o
elide	vb	o
elided	vbn	o
ellipsis	nn	o
else	rb	o
elsewhere	rb	o
embed	vb	o
embedded	jj	o
embedding	vbg	o
embeds	vbz	o
empty	jj	o
empty	rb	o
enables	vbz	o
enclosed	vbn	o
enclosing	vbg	o
encode	nn	o
encoded	vbn	o
encoding	nn	o
encompasses	vbz	o
encounters	vbz	o
encouraged	vbn	o
end	nn	o
ends	vbz	o
enforces	vbz	o
enough	rb	o
ensure	vb	o
entering	vbg	o
entire	jj	o
entirely	rb	o
entities	nns	o
entity	nn	o
entries	nns	o
entry	nn	o
enumerations	nns	o
environments	nns	o
equal	jj	o
equal	vb	o
equality	nn	o
equals	vbz	o
equivalent	jj	o
equivalent	nn	o
erroneous	jj	o
erroneously	rb	o
error	nn	o
errors	nns	o
escapes	nns	o
evaluate	vbp	o
evaluated	vbn	o
evaluates	vbz	o
evaluating	vbg	o
evaluation	nn	o
even	rb	o
events	nns	o
exact	jj	o
exactly	rb	o
example	nn	o
examples	nns	o
exception	nn	o
exclude	vb	o
excludes	vbz	o
execute	vb	o
executed	vbn	o
executes	nns	o
executes	vbz	o
executing	vbg	o
execution	nn	o
exist	vb	o
existing	vbg	o
exists	vbz	o
exits	vbz	o
exp	nn	o
explicit	jj	o
explicitly	rb	o
exploits	vbz	o
exponent	nn	o
exported	jj	o
exported	vbn	o
exports	nns	o
expressed	vbn	o
expression	nn	o
expressions	nns	o
extend	vb	o
extended	jj	o
extended	vbn	o
extent	nn	o
extra	jj	o
extract	vb	o
facilities	nns	o
factor	nn	o
failure	nn	o
fall	vbp	o
false	jj	o
fewer	jjr	o
field	nn	o
fields	nns	o
file	nn	o
files	nns	o
final	jj	o
finally	rb	o
first-in-first-out	jj	o
fit	vb	o
fits	vbz	o
floating	vbg	o
floating-point	jj	o
floating-point	nn	o
flow	vb	o
flows	vbz	o
followed	vbn	o
following	vbg	o
follows	vbz	o
forever	rb	o
form	nn	o
formal	jj	o
formats	nns	o
formed	vbn	o
forms	nns	o
forms	vbp	o
fraction	nn	o
fractional	jj	o
full	jj	o
fully	rb	o
function-local	jj	o
functionality	nn	o
functions	nns	o
functions—happens	nns	o
further	rbr	o
fused	jj	o
fused	vbn	o
fusion	nn	o
garbage-collected	jj	o
general	jj	o
general-purpose	jj	o
generated	vbn	o
generates	vbz	o
generator	nn	o
get	vbp	o
given	vbn	o
gives	vbz	o
goroutine	nn	o
goroutines	nns	o
goto	nn	o
grammar	nn	o
greater	jjr	o
group	nn	o
grow	vb	o
guaranteed	vbn	o
guarantees	nns	o
guard	nn	o
halves	nns	o
hand	nn	o
handling	vbg	o
happen	vb	o
have	vb	o
hexadecimal	jj	o
hexadecimal	nn	o
hidden	jj	o
hierarchy	nn	o
high	jj	o
higher-dimensional	jj	o
highest	jjs	o
hint	nn	o
hold	vb	o
holding	vbg	o
holds	vbz	o
horizontal	jj	o
however	rb	o
hypothetical	jj	o
identical	jj	o
identified	vbn	o
identifier	nn	o
identifiers	nns	o
identify	vb	o
identifying	vbg	o
identity	nn	o
idiomatic	jj	o
ignore	vb	o
ignored	vbn	o
ignoring	vbg	o
illegal	jj	o
illustrates	vbz	o
imaginary	jj	o
immaterial	jj	o
immediately	rb	o
immutable	jj	o
implement	vb	o
implementation	nn	o
implementation-defined	jj	o
implementation-dependent	jj	o
implementation-specific	jj	o
implementations	nns	o
implemented	vbd	o
implements	vbz	o
implicit	jj	o
implicit	nn	o
implicitly	rb	o
implied	vbn	o
import	nn	o
imported	vbn	o
importing	nn	o
imports	nns	o
imports	vbz	o
impossible	jj	o
include	vb	o
included	vbn	o
includes	vbz	o
including	vbg	o
inclusive	jj	o
incoming	nn	o
increasing	vbg	o
increment	nn	o
incur	vb	o
independent	jj	o
independently	rb	o
index	nn	o
indexed	vbn	o
indexing	nn	o
indicate	vb	o
indication	nn	o
indices	nns	o
indirection	nn	o
indirections	nns	o
indirectly	rb	o
indirects	vbz	o
individual	jj	o
individually	rb	o
infinite	jj	o
infinity	nn	o
influence	nn	o
informally	rb	o
information	nn	o
inhabit	nn	o
inherit	vb	o
init	nn	o
initial	jj	o
initialization	nn	o
initialization—variable	jj	o
initialize	vb	o
initialized	vbn	o
initializer	jj	o
initializers	nns	o
initializes	vbz	o
initializing	vbg	o
inner	jj	o
innermost	nn	o
input	nn	o
inserted	vbn	o
insertion	nn	o
installed	vbd	o
instance	nn	o
instead	rb	o
instruction	nn	o
instructions	nns	o
int	nn	o
integer	jj	o
integer	nn	o
integers	nns	o
integral	jj	o
integrated	jj	o
interface	nn	o
interface-valued	jj	o
interfaces	nns	o
intermediate	jj	o
internal	jj	o
interpretation	nn	o
interpreted	vbn	o
introduce	vb	o
introduced	vbn	o
introducing	vbg	o
invalid	jj	o
inverse	nn	o
invocation	nn	o
invocations	nns	o
invoke	vb	o
invoked	vbn	o
invokes	vbz	o
invoking	vbg	o
involves	vbz	o
involving	vbg	o
iota	nn	o
irrelevant	jj	o
irrespective	nn	o
issues	nns	o
item	nn	o
items	nns	o
iterates	vbz	o
iteration	nn	o
iterations	nns	o
jump	nn	o
just	rb	o
key	jj	o
key	nn	o
keys	nns	o
keyword	nn	o
keywords	nns	o
kind	nn	o
kinds	nns	o
known	vbn	o
label	nn	o
labeled	jj	o
labeled	vbn	o
labeling	vbg	o
labels	nns	o
language	nn	o
large	jj	o
larger	jjr	o
largest	jjs	o
last	jj	o
later	rb	o
launch	vb	o
leading	vbg	o
least	jjs	o
left	nn	o
left-	jj	o
left-hand	jj	o
left-to-right	jj	o
leftmost	nn	o
legal	jj	o
legally	rb	o
length	nn	o
lengths	nns	o
less	jjr	o
letter	nn	o
letters	nns	o
level	nn	o
levels	nns	o
lexical	jj	o
lexically	rb	o
light-weight	jj	o
limit	nn	o
limited	jj	o
limits	nns	o
line	nn	o
linguistic	jj	o
linking	vbg	o
list	nn	o
listed	vbn	o
listing	vbg	o
lists	nns	o
literal	jj	o
literal	nn	o
literally	rb	o
literals	nns	o
local	jj	o
location	nn	o
logical	jj	o
long	rb	o
longest	jjs	o
looks	vbz	o
loop	nn	o
low	jj	o
low-level	jj	o
lower	jjr	o
lower-case	jj	o
made	vbn	o
main	jj	o
make	vb	o
manage	vb	o
management	nn	o
mantissa	nn	o
manual	nn	o
manually	rb	o
map	nn	o
maps	nns	o
mark	nn	o
marked	vbn	o
marking	vbg	o
mask	nn	o
match	vb	o
match	vbp	o
matches	nns	o
matching	vbg	o
maximum	jj	o
meaning	nn	o
measure	nn	o
mechanism	nn	o
memory	nn	o
methods	nns	o
mind	nn	o
minimal	jj	o
minimum	nn	o
missing	jj	o
mixed	vbn	o
modify	vb	o
modulo	jj	o
moment	nn	o
more	jjr	o
most	jjs	o
multi-byte	nn	o
multi-character	jj	o
multi-dimensional	jj	o
multi-valued	jj	o
multi-variable	jj	o
multi-way	jj	o
multiple	nn	o
multiplied	vbn	o
multiply	nn	o
n-bit	jj	o
named	vbn	o
names	nns	o
names	vbz	o
nearest	jjs	o
necessary	jj	o
negation	nn	o
negative	jj	o
nest	jjs	o
nested	jj	o
never	rb	o
new	jj	o
newline	jj	o
newline	nn	o
newlines	nns	o
next	jj	o
nil	jj	o
nn	jj	o
nnn	jj	o
no-op	jj	o
non-	jj	o
non-blank	jj	o
non-complex	jj	o
non-constant	jj	o
non-constants	nns	o
non-decimal	jj	o
non-empty	jj	o
non-exported	jj	o
non-interface	jj	o
non-interface	nn	o
non-negative	jj	o
non-variadic	jj	o
normal	jj	o
normally	rb	o
not-a-number	jj	o
notation	nn	o
nothing	nn	o
nth	jj	o
number	nn	o
numbered	jj	o
numbers	nns	o
numeric	jj	o
objects	nns	o
obtained	vbn	o
occupy	vb	o
occur	vb	o
occurs	nn	o
occurs	nns	o
octal	jj	o
octal	nn	o
offset	nn	o
omit	vb	o
omitted	vbn	o
once	rb	o
one-dimensional	jj	o
op	jj	o
opening	nn	o
operand	nn	o
operands	nns	o
operation	nn	o
operations	nns	o
operator	nn	o
operators	nns	o
opposed	vbn	o
optimize	vb	o
optional	jj	o
optionally	rb	o
order	nn	o
ordered	vbd	o
ordered	vbn	o
ordering	nn	o
ordinary	jj	o
organization	nn	o
original	jj	o
originally	rb	o
other	jj	o
otherwise	rb	o
overflow	nn	o
overlaps	vbp	o
overriding	vbg	o
overwrite	vb	o
own	jj	o
package-level	nn	o
packages	nns	o
panic	jj	o
panic	nn	o
panicking	nn	o
panicking	vbg	o
panics	nns	o
parameter	nn	o
parameters	nns	o
parentheses	nns	o
parentheses	vbz	o
parenthesized	vbn	o
parse	vb	o
parsed	vbn	o
parsing	jj	o
part	nn	o
particular	jj	o
parts	nns	o
pass	vb	o
passed	vbd	o
passing	nn	o
path	nn	o
performed	vbn	o
period	nn	o
permissible	jj	o
permit	vb	o
permits	vbz	o
permitted	vbn	o
permitting	vbg	o
phases	nns	o
place	nn	o
placed	vbn	o
placeholder	nn	o
plain	nn	o
point	nn	o
pointed	vbn	o
pointer	nn	o
pointer-receiver	jj	o
pointers	nns	o
pointing	vbg	o
points	nns	o
portability	nn	o
portable	jj	o
position	nn	o
possible	jj	o
possibly	rb	o
post	nn	o
power	nn	o
preceded	vbn	o
precedence	nn	o
preceding	vbg	o
precise	jj	o
precisely	rb	o
precision	nn	o
predeclared	jj	o
predeclared	vbn	o
predeclares	vbz	o
prefix	nn	o
prefixed	vbn	o
present	jj	o
present	vb	o
presented	vbn	o
preventing	vbg	o
prevents	vbz	o
previous	jj	o
previously	rb	o
primary	jj	o
prime	jj	o
printing	nn	o
proceed	vb	o
proceeds	nns	o
process	nn	o
produce	vb	o
produced	vbn	o
produces	vbz	o
production	nn	o
productions	nns	o
program	nn	o
program-defined	jj	o
programming	nn	o
programs	nns	o
promoted	vbn	o
properties	nns	o
protects	vbz	o
provide	vbp	o
provided	vbn	o
provides	vbz	o
pseudo-random	jj	o
punctuation	nn	o
purpose	nn	o
qualified	jj	o
qualified	vbn	o
qualifier	nn	o
queues	nns	o
quote	nn	o
quoted	vbn	o
quotes	nns	o
quotient	nn	o
radix	nn	o
raised	vbn	o
range	nn	o
ranges	nns	o
rare	jj	o
rather	rb	o
raw	jj	o
re-used	jj	o
re-uses	vbz	o
reach	vb	o
reachable	jj	o
reached	vbd	o
reaches	nns	o
read	vb	o
readability	nn	o
ready	jj	o
ready	vbp	o
real	jj	o
receive	nn	o
receive	vbp	o
receive-only	jj	o
received	jj	o
received	vbn	o
receiver	nn	o
receives	nns	o
receiving	vbg	o
recent	jj	o
records	nns	o
recursively	rb	o
redeclaration	nn	o
redeclare	vb	o
redeclared	vbn	o
refer	vb	o
reference	nn	o
referenced	vbn	o
references	vbz	o
referred	vbn	o
referring	vbg	o
refers	nns	o
reflect	vb	o
reflection	nn	o
regardless	rb	o
regular	jj	o
related	jj	o
relation	nn	o
relationship	nn	o
relationships	nns	o
relative	vbp	o
rely	vb	o
remain	vbp	o
remainder	nn	o
remains	vbz	o
removed	vbn	o
removes	vbz	o
repeated	jj	o
repeatedly	rb	o
repeating	vbg	o
repetition	nn	o
replaced	vbn	o
replacement	nn	o
reported	vbn	o
reporting	nn	o
reports	vbz	o
repository	nn	o
represent	vbp	o
representable	jj	o
representation	nn	o
representations	nns	o
represented	vbn	o
representing	vbg	o
represents	vbz	o
reproducible	jj	o
require	vb	o
required	vbn	o
requirement	nn	o
requirements	nns	o
reserved	vbn	o
reserves	nns	o
resolve	vb	o
respective	jj	o
respectively	rb	o
restrict	vb	o
restricted	vbn	o
restriction	nn	o
restrictions	nns	o
result	nn	o
resulting	vbg	o
results	nns	o
resumes	nns	o
retrieved	vbn	o
return	nn	o
return	vb	o
returned	vbn	o
returning	vbg	o
returns	nns	o
returns	vbz	o
reverse	nn	o
rewritten	vbn	o
right	nn	o
right	vb	o
right-hand	jj	o
right-hand-side	jj	o
room	nn	o
round-to-even	jj	o
rounded	vbn	o
rounding	nn	o
rounding	vbg	o
rounds	vbz	o
routine	nn	o
rule	nn	o
rules	nns	o
run	vb	o
run	vbn	o
run-time	jj	o
rune	nn	o
runes	nns	o
running	nn	o
safety	nn	o
said	vbd	o
satisfies	vbz	o
satisfy	vbp	o
saved	vbd	o
scales	vbz	o
scope	nn	o
scoped	nns	o
scopes	vbz	o
scoping	nn	o
second	jj	o
section	nn	o
see	vb	o
segment	nn	o
select	jj	o
select	nn	o
selected	vbn	o
selecting	vbg	o
selection	nn	o
selector	nn	o
selectors	nns	o
semantically	rb	o
semicolon	nn	o
semicolons	nns	o
send	vb	o
sender	nn	o
sending	vbg	o
sends	nns	o
sends	vbz	o
sent	nn	o
sent	vbn	o
separates	vbz	o
sequence	nn	o
sequences	vbz	o
sequential	jj	o
sequentially	rb	o
serve	vbp	o
serves	vbz	o
set	nn	o
set	vbn	o
sets	vbz	o
setting	vbg	o
several	jj	o
shallowest	nn	o
share	nn	o
shared	vbn	o
shares	nns	o
sharing	vbg	o
shift	nn	o
shifted	vbn	o
shifts	nns	o
short	jj	o
shorthand	nn	o
show	vbp	o
side	nn	o
side-effects	nns	o
sieve	nn	o
sign	jj	o
signature	nn	o
signatures	nns	o
signed	vbn	o
significantly	rb	o
similar	jj	o
simple	nn	o
simplest	jjs	o
simplicity	nn	o
simplified	vbd	o
single	jj	o
single-character	jj	o
single-valued	jj	o
site	nn	o
size	nn	o
sizes	nns	o
skipped	vbn	o
skips	pdt	o
sliced	jj	o
slices	nns	o
slicing	vbg	o
snippets	nns	o
so	rb	o
solely	rb	o
sometimes	rb	o
source	nn	o
space	nn	o
spaces	nns	o
speaking	vbg	o
spec	nn	o
special	jj	o
specially	rb	o
specific	jj	o
specification	nn	o
specifications	nns	o
specified	vbn	o
specifier	nn	o
specifies	vbz	o
specify	vb	o
specifying	vbg	o
spelled	vbn	o
square	jj	o
standard	nn	o
standard	vbn	o
stands	vbz	o
start	vb	o
starting	vbg	o
starts	vbz	o
state	nn	o
statement	nn	o
statements	nns	o
states	vbz	o
static	jj	o
stay	vb	o
step	nn	o
steps	nns	o
stepwise	nn	o
still	rb	o
stop	vb	o
stops	nns	o
storage	nn	o
store	vb	o
stored	vbn	o
stream	nn	o
string	nn	o
string	vbg	o
strings	nns	o
strongest	jjs	o
strongly	rb	o
struct	nn	o
structs	nns	o
structurally	rb	o
structure	nn	o
structured	jj	o
subexpressions	nns	o
subsequent	jj	o
subset	nn	o
substitution	nn	o
substring	nn	o
succeeded	vbd	o
succeeds	vbz	o
successful	jj	o
successive	jj	o
such	jj	o
sufficiently	rb	o
sum	nn	o
superset	nn	o
support	nn	o
supported	vbn	o
surrogate	jj	o
surrounding	vbg	o
survive	vbp	o
switch	nn	o
switch	vb	o
switches	nns	o
switches	vbz	o
synchronization	nn	o
syntax	nn	o
system	nn	o
systems	nns	o
table	nn	o
tabs	nn	o
tag	nn	o
tags	nns	o
take	vb	o
takes	vbz	o
taking	vbg	o
target	nn	o
temporary	jj	o
term	nn	o
terminated	vbn	o
terminates	nns	o
terminates	vbz	o
terminating	nn	o
terminating	vbg	o
termination	nn	o
terminators	nns	o
terms	nns	o
tested	vbn	o
text	nn	o
textual	jj	o
then	rb	o
there	ex	o
therefore	rb	o
thread	nn	o
three-digit	jj	o
thus	rb	o
time	nn	o
times	nns	o
together	rb	o
token	nn	o
tokens	nns	o
too	rb	o
tools	nns	o
top	jj	o
top-level	jj	o
top-to-bottom	jj	o
transfers	nns	o
transitively	rb	o
traversed	vbd	o
treated	vbn	o
trigger	vbp	o
triggers	nns	o
true	jj	o
truncated	vbn	o
truncation	nn	o
truth	nn	o
tuple	jj	o
turn	nn	o
twice	rb	o
two-digit	jj	o
type	nn	o
type-specific	jj	o
typed	jj	o
types	nns	o
types—array	nn	o
types—may	rb	o
typically	rb	o
unable	jj	o
unary	jj	o
unbuffered	jj	o
unchanged	jj	o
underlying	vbg	o
underscore	jj	o
underscores	nns	o
unescaped	jj	o
uniform	jj	o
unimported	jj	o
uninitialized	jj	o
uninterpreted	jj	o
union	nn	o
unique	jj	o
unit	nn	o
universe	jj	o
unnamed	jj	o
unordered	jj	o
unparenthesized	jj	o
unqualified	jj	o
unsigned	jj	o
unspecified	jj	o
untyped	jj	o
upper	jj	o
used	vbn	o
useful	jj	o
uses	vbz	o
using	vbg	o
usual	jj	o
valid	jj	o
value	nn	o
value-receiver	jj	o
values	nns	o
variable	jj	o
variable	nn	o
variables	nns	o
variadic	jj	o
variants	nns	o
various	jj	o
vary	vb	o
versa	nn	o
vetted	vbn	o
vice	nn	o
violate	vbp	o
visible	jj	o
vocabulary	nn	o
wait	vb	o
was	vbd	o
way	nn	o
ways	nns	o
well	rb	o
were	vbd	o
wide	jj	o
width	nn	o
wishes	vbz	o
word	nn	o
words	nns	o
wrap	nn	o
write	vb	o
written	vbn	o
yet	rb	o
yield	vb	o
yielding	vbg	o
yields	nns	o
zero-size	jj	o
